## 用于轻量化提示，使用/上屏，不得重码，text为上屏用，第一列为最终上屏内容，部署时，会写入leveldb数据库不占用内存，支持大数据遍历
起	q/
为	w/
二	e/
让	r/
她	t/
一	y/
上	u/
成	i/
偶	o/
平	p/
安	a/
三	s/
都	d/
发	f/
给	g/
会	h/
见	j/
看	k/
来	l/
走	z/
想	x/
才	c/
着	v/
不	b/
那	n/
没	m/
😲	aa/
😦	aaa/
😧	aaaa/
😄	ha/
😄	haha/
🐸	qywa/
🐸	qkwa/
H₂O	uv/
H₂O	shui/